AÇELYA: Fundagillerden çok renkli çiçekler açan bitki
AÇILAY: Ay`ın şekilleri, yansıması
ADAL: Ün kazan
AFET: Ortalığı birbirine katacak kadar güzel kadın
AFİFE: Namuslu, namusuna çok düşkün olan
AFİTAP: 1.Güneş. 2. Çok güzel, parlak yüzlü kadın
AĞÇA: Temiz, saf
AHENK: Uyum
AHSEN: Çok güzel, olağanüstü güzel
AHU: Ceylan, karaca 2.Çok güzel,ince,zarif kadın.
AHUCAN: Çok güzel dost.
AHUEDA:Nazlı güzel.
AHUELA:Çok güzel gözlü.
AHUGÜL: Çok güzel.
AHUGÜZAR:Becerikli güzel.
AHUNAZ: Nazlı güzel,
AHUNİSA:Çok güzel kadın.
AHUNUR:Göz kamaştıran güzelliğe sahip olan.
AHUSE: Coşkulu güzellik
AHUŞEN:Güzel ve neşeli.
AJDA:Filiz,sürgün. Çok genç.
AJLAN: Hızlı, çabuk, telaşlı
AKASYA: Güzel kokulu bir süs bitkisi
AKEL: Eli uğurlu anlamında
AKGÜN: Parlak gün, uğurlu gün, ışıklı gün
AKSEV: Aydınlığı sev,ışık saç
AKSU: Anadolu`da değişik boylarda bir çok akarsuyun adı
AKŞIN: Beyaz tenli kadın
AKTAN: Ak renkli tan; Kutlu tan, uğurlu tan
ALA: Ela karışık renkli, alaca; Benekli; Tam olgunlaşmamış, yarı olmuş
ALAGÜL: Çok renkli gül.
ALÇİÇEK: Kırmızı çiçek.
ALÇİN: Kızıl renkli küçük bir kuş
ALEDA: Nazlı, kaprisli
ALEV: Yanan cisimlerin görüntüsünü tarif etmek için kullanılan bir kelime
ALEYNA: Bizim üzerimize olsun
ALGIN: Birine gönül vermiş, vurgun, tutkun
ALGÜL: Kırmızı gül. Gül kırmızısı
ALIM: Gözü gönlü çeken nitelik, çekicilik, gönül çelen güzellik, albeni
ALKIM: Gökkuşağı
ALKIZ: Kırmızı yanaklı,sağlıklı kız.
ALTIN: Yüksek değerli bir maden
ALYA: Yüksek yer, yükseklik, gök
AMİNE: Yüreğinde korku olmayan.
ANDAÇ: Anılar, hatıralar
ANIL: Başkaları tarafından sözün edilsin
ANKA: Kaf Dağı`nda bulunduğu söylenen masal kuşu
ARIN: Arı, katışıksız, temiz, kirden uzak
ARKIN: Yavaş, ağır, sakin
ARMAĞAN: Hediye, ödül
ARNİSA: Çok namuslu kadın
ARSEN: Kurtuluş, özgürlük
ARSU: Su kadar berrak
ARSUN: Yüreğindeki temizliği yansıtan
ARZU: Herhangi bir şey için duyulan aşırı istek
ARZUCAN: Candan isteyen.
ARZUGÜL: İstenilen,beğenilen gül.
ARZUM: İsteğim,dileğim,hevesim.
ARZUNAZ: Naz yapan,
ASALBİKE: Gerçek hanım, gerçek güzel
ASEL: Bal, Cennetteki dört sudan biri
ASENA: Dişi kurt, güzel kız
ASLI:Temelli,köklü. Bir şeyin benzeri.
ASLICAN:Özü can gibi sevgili
ASLIM: Özü geçmişe ait
ASLINAZ:Nazlı olması geçmişinden gelen.
ASLINUR:Nur saçan bir geçmişi olan.
ASLISU:Geçmişi su gibi berrak ve temiz olan. 
ASU: Azgın, huysuz,isyan eden. Afacan.
ASUDE: Rahat, huzur içinde olan
ASUELA: Ela gözlü yaramaz
ASYA: Dünyanın en büyük kıtası
AŞINA:Bildik,tanıdık.
AŞKIM:Sevdiğim,sevgilim.
AŞKIN: Aşmış, ileri
AYBEN: Ben ayım anlamında
AYBENİZ:Ay gibi parlak tenli,ay benizli.
AYBİKE: Ay gibi güzel kız
AYBİRGEN: Ay veren
AYCAN:Ay gibi sevilen,aydınlık can.
AYÇA: Yay biçimindeki ay,Hilal.
AYÇAĞ:Ay gibi parlak çağ.
AYÇAN:Ay gibi aydınlık kişi.
AYÇİÇEK: Gün çiçek
AYDA: Dere kıyılarında yetişen bir bitki
AYDAN: Güzelliğini aydan almış,ay gibi parlak ve güzel
AYDENİZ: Hem ay, hem de deniz
AYDONAT: Işık donat, parlaklık donat anlamında
AYEVİ: Ay çevresinde oluşan ışık çemberi
AYGEN: Gönül arkadaşı
AYGÖNÜL:Güzel gönüllü.
AYGÜN: Hem ay, hem gün
AYKAL: Ay gibi parlak ve ışıklı kal
AYKIZ: Ay+Kız
AYKUT: Kutlu ay, uğurlu ay
AYLA: Bazı yıldızların ve ayın etrafındaki ışık çemberi
AYLAN: Ay gibi güzel değerlere sahip olan.
AYSAR: Ayın evrelerine göre huyu değişen kimse
AYSEL: Ay gibi olan güzelliğiyle nam salmış olan
AYSEMA: Ay gibi parıldayan yüz.
AYSEREN: Güzelliğini gözler önüne seren.
AYSIN: Sen aysın, ay kadar güzelsin
AYSU: Ay gibi parıltılı ve su gibi berrak.
AYSUN: Ay gibi ışıltılı ve güzel.
AYŞE: Rahat ve huzur içinde yaşayan
AYŞEN: Neşeli,gülen,aydınlık.
AYŞENUR: Ayşe+Nur
AYŞIL: Ay ışığı
AYŞİM,AYŞİN: Darlak ışık saçan.
AYTU: Aya benzeyen tuğlu.
AZİZE: Saygın,sevgili,kutsal.
ADALET: Doğruluk, zulmetmeme, haksızları terbiye.
ADNİYE: Salih, Cennetlik.
AHU: Ceylan, maral.
AİŞE: Bolluk içinde rahat yaşayan.
ASİYE: Direk, acılı kadın.
ASLI: Temelli, köklü.
ASLIHAN: Han soyundan olan.
ASUMAN: Gök, gökkubbe, sema.
ATİYE: Bağış, verme, iyilik.
ATIFET: Bir sebebi bulunmadan duyulan sevgi.
AYFER: Ay ışığı.
AYLA: Kadın, eş hanım.
AYLİN: Ayın çevresinde görülen ışıklı daire, hale.
AYNUR: Ay gibi parlak.
AYPERİ: Peri gibi güzel.
AYTEN: Ay gibi parlak renkli.
AYŞEGÜL: Güleç, gül gibi renkli, canlı ve rahat ömür süren.
AZİMET: Gidiş. Takva yolunu seçen.
AZRA: Bakire.
