DAMLA:Çok küçük miktarda su. Çok az.
DALGA: Hareketli su kütlesi; Denizin rüzgarlı havada kabarıp kıyıya sürüklenmesi
DEFNE: Yaprakları güzel kokulu, yaz-kış yeşil olan bir bitki
DEMET: Çiçek bağlamı, deste
DEMİ:Kadife,şeftali gibi şeylerin üzerinde bulunan ince tüy
DENİZ: Yeryüzünün çoğunu örten engin su
DEREN: Toplayan, düzenleyen, pekiştiren
DERİN: Sığ olmayan
DERYA: Büyük deniz anlamında
DERYANUR:Bilgisiyle ışık saçan.
DESEN: Çiçek, çizgi gibi süs şekilleri
DESTE:Bağlam,demet.
DESTEGÜL: Mevlevi dervişlerinin giydiği ince kumaştan yelek. Bağlanmış gül demeti.
DEVİN: Hareket, kımıldanış
DEVİNSU:Suyun ritmik hareketleri. Akarsu.
DEVRİN:Bir kişi veya olayın gündemde olduğu tarih dönemi.
DİCLE: Bir nehir adı. Ulu ırmak.
DİDAR:Güzel yüz. Görme.
DİDE: Göz, göz bebeği
DİDEM: Gözüm gibi sevdiğim, sevgilim
DİLA:Gönlümü çalan.
DİLAN:Gönüllerce olan,yürekler dolusu.
DİLARA: Gönül alan, gönül okşayan.
DİLAY: Gönle ışık saçan, ay kadar güzel
DİLBER:Gönlü yakan güzel. Alımlı güzel kadın.
DİLDAR: Gönlü baskı altında tutan sevgili
DİLDE: Ünü her tarafa yayılmış, herkesin konuştuğu, herkesin dilinde olan kimse
DİLEK: İstek, rica,arzu.
DİLEM: Gönül ilacı
DİLER: Dilemek eyleminden
DİLHAN: İçten ve yürekten konuşan
DİLNİŞİN: Gönülde yer tutan,hoş,güzel
DİLRÜBA: Gönlü şen,dertsiz
DİLSEREN:Hatiplik yeteneğini gözler önüne seren.
DİLSU: Dil+Su
DİLŞAH: Gönül şahı,sevgili,sultan.
DİNİZ:Sakin,dingin.
DOĞA: Yaradılış ve yapı özelliklerinin tümü; Tabiat
DOĞANGÜN: Doğmakta olan gün
DOĞAY: Ayın yeni doğuş hali
DOĞU: Güneşin doğduğu ana yön
DOLUNAY:Ayın tam yuvarlak olduğu an
DORA: Doruk, zirve
DURUGÜL:Gül gibi temiz olan.
DUYGU: Kişi, olay ve nesnelerin bireyin iç dünyasında uyandırdığı izlenim
DUYGUN: Duygulu,hassas,hisli kişi.
DUYGUNİSA: Duygulu,hassas kadın.
