EBRU:1.Keman kaş. 2.Bulut rengi. 3.Bir sanat dalı
ECE: Kraliçe. Güzel kız,kadın.
ECEGÜN: Çok güzel bir günde doğan
ECEM: Kraliçem, sevgili kraliçe anlamında
ECENAZ:Nazlı güzel.
ECESU:Su gibi berrak ve güzel.
ECMEL: Çok güzel
EDA: Naz, cilve. Davranış,tavır. Verme,ödeme. (Namaz için)kılma,yerine getirme. Üslup.
EFİL:Rüzgar,dalgalanma.
EGE: Türkiye`nin batısında yer alan deniz
ELANAZ:Ela gözlü,nazlı güzel.
ELANUR:Ela gözleriyle nur saçan.
ELÇİN: Deste, tutam
ELİF: Kibar, narin yapılı, ince-uzun boylu kız.
ELİFE:Tutku,istek,alışılan şey.
ELİZ:El izi.
ELVAN: Renkler,çeşitler.
EMEL:Arzu,özlem.
EMET: Bereket, bolluk
EMİNE: İnanılır,güvenilir.
ENER: Dağ eteği
EREM: Cennet
ERENDİZ: Jüpiter gezegeninin adı
ERÇİL: Doğru,inanılır,güvenilir kişi.
ERDA: Beyaz karınca.
ESEN: Sağlıklı, salim
ESENGÜL: Rüzgar gibi esen,Gül gibi güzel kokan.
ESER: Emek sonucu ortaya çıkan ürün, yapıt; Yok olmuş bir nesneden kalan parça
ESİM: Rüzgar gibi olan.
ESİN: Sabah rüzgarı
ESMA: İsimler,adlar. Çok yüksek olan.
ESMACAN: Adı can olan.
ESMAGÜL: Adı gül.
ESMANUR: Adı nur.
ESNA: Yüksek, yüce. Bir işin yapıldığı an.
ESRA: En çabuk, çok çabuk
EŞAY: Ayin güzelliğiyle eşdeğer güzelliğe sahip olan.
EŞLEM: Selametli, güvenilir
EVA: Havva. Yaratılan ilk kadın.
EVİN: Bir şeyin içindeki öz; Buğday tanesinin olgunlaşmış içi, özü
EYLÜL: Sonbaharda bir ay adı
EZGİ: Melodi, şarkı, türkü
EZGİN: Sesi düzenli gelen. Paraca durumu bozuk olan. Çok sıkıntı çekmiş.
