GAMZE: Göz kırpma, gözle işaret; Nazlı bakma; Gülerken bazı kişilerde yanaklarda beliren çukur
GAYE: Amaç, erek
GAZAL: Ak geyik, ahu; Geyik yavrusu; Güzel söz (mecazi)
GAZEL: Konusu daha çok sevgi ve içki olan, manzume; Tek kişinin özel ahenkte okuduğu müzik parçası; Sonbahar vaktinde düşen yapraklar
GELİNCİK: Yazın kırlarda yetişen parlak kırmızı renkli bir çiçek
GENCAY: Yeni doğmuş ay; Hilal biçimindeki ay
GERÇEK: Yakıştırma veya yalanı olmayan
GİZEM: Sır; Aklın erişemediği çözülemeyen şey
GONCA: Tam açılmamış çiçek
GONCAGÜL: Gül goncası.
GÖK: Yerin göz ile görülebilen ufuklarından başlayarak yukarıda kubbenin içi gibi gözüken sonsuz boşluk; Mavi renk
GÖKAY: Hem gök, hem ay; Güzel ay
GÖKBEN: Ben gökyüzü anlamında
GÖKÇE: Gök mavisi, mavi gözlü güzel
GÖKÇENAZ: Nazlı mavi.
GÖKSU: Türkiye`nin çeşitli yerlerinde bulunan akarsuların adı
GÖKYEL: Kuzeydoğudan esen rüzgar, poyraz
GÖNEN: Rutubet, yaşlık; Ekilecek toprağın tavlandırılması
GÖNÜL: İstek, arzu, sevgi.
GÖNÜLGÜL: Gül gibi zarif bir gönlü olan.
GÖRKE: Heybetli
GÖRKEM: Göz alıcı ve gösterişli olma durumu,ihtişam.
GÖZDE: Çok sevilen, beğenilen nitelikte olan. Çok güzel.
GÖZDEM: Beğendiğim,sevdiğim,saydığım,bitanem.
GÖZDENAZ: Nazlı güzel.
GÖZDENUR: İnsanlara vermiş olduğu iç huzurla herkesin beğenisini kazanan.
GÖZEN: İlgi çekici, samimi; Sulak yer; Pınar
GÜHER: Cevher
GÜL: Gülgillerin örneği olan bitki ve bunun çiçeğine verilen ad; Gülmek eyleminden gül
GÜLAL: Gülün kırmızısı gibi güzel.
GÜLAY: Gül gibi güzel, ay gibi aydınlık olan.
GÜLBAHAR: Ebru yapmakta kullanılan koyu kırmızı toprak rengi
GÜLBEN: Gül yüzlü,gül gibi beni olan.
GÜLBİN: Gül fidanı, gül yetişen yer.
GÜLCAN: Gül gibi güzel kişi.
GÜLCE: Gül gibi.
GÜLÇİÇEK: Her yönüyle güzel olan.
GÜLÇİN: Gül toplayan, gül seven.
GÜLDEN: Güle ilişkin, gülden yapılmış. Gül soluklu.
GÜLEDA: Gül gibi güzel ve nazlı.
GÜLEN: Güleç yüzlü, mutlu anlamında
GÜLENAY: Güleç ay, gülümseyen ay; Ay gibi gülümseyen güzel
GÜLFEM: Ağzı gül gibi olan
GÜLFER: Zarifliği ve güzelliğiyle göz kamaştıran.
GÜLGEN: Güler yüzlü
GÜLGÜN: Gül renkli; Gülen, gülümseyen
GÜLHAN: Gül kadar çok sevilen, han, hakan
GÜLİN: Güzel,zarif.
GÜLİNAZ: Nazlı,güzel.
GÜLİSTAN: Gül bahçesi
GÜLİZ: Gül yetiştiren
GÜLİZAR: Al yanaklı, gül yanaklı; Alaturka müzikte bir bileşik bir makam
GÜLNİHAL: Gül fidanı.
GÜLNİSA: Gül gibi kadınlar anlamında
GÜLNUR: Işık saçan güzellik.
GÜLPERİ: Gizemli gül, saklı gül.
GÜLRİZ: Gül saçan
GÜLRU: Gül yüzlü, gül yanaklı
GÜLSANEM: Çok güzel kadın.
GÜLSELİ(N): Coşkulu bir güzelliğe sahip olan.
GÜLSU: Gül ve su gibi güzel
GÜLSÜN: Yaşam boyu yüzü gülsün anlamında
GÜLŞAH: Gül dalı; Güzelliğiyle ün salmış olan
GÜLŞEN: Gül bahçesi
GÜLTEN: Gül tenli, vücudu gül gibi
GÜN: 24 saatlik zaman dilimi; Güneşin yeryüzüne gönderdiği ışık; Güneş, yaşam
GÜNAL: Işık al, ışıklı ol
GÜNAN: Doğumuyla sevinç getiren; Anılan gün
GÜNAY: Hem gün, hem ay
GÜNÇİÇEK: Ay çiçek
GÜNDEN: Güne ilişkin, güneşe ilişkin; Güneşten bir parça
GÜNDÜZ: Günün aydınlık bölümü
GÜNEŞ: Çevresindeki gezegenlere ısı ve ışık veren büyük gök cismi
GÜNEY: Her zaman güneş gören, güneşli yer; Bir yön
GÜNHAN: Oğuzhan`ın altı oğlundan biri
GÜNNAZ: Nazlı kişi.
GÜNNUR: Güneş gibi ışık saçan.
GÜNSU: Gün gibi aydınlık, su gibi berrak
GÜRAY: Bol ışıklı ay, güçlü ay
GÜRDAL: Güçlü dal, sık dal
GÜVEN: Güvenmekten, yürekli ol anlamında
GÜZ: Sonbahar
GÜZEL: Hoşa giden,hayranlık uyandıran
GÜZİN: Seçilmiş, seçkin. Beğenilen.
GÜZÜN: Güz mevsiminde olan
