İCLAL: Ağırlama,ikram. Büyüklük,ululuk.
İDİL: Kır yaşamı içinde aşk konusunu işleyen kısa şiir; Volga ırmağına Türkler`in verdiği ad
İDİLSU: Su için yazılmış şarkı.
İLAYDA: Su perisi
İLBÜKE: İlbey hanımı, seçkin hanım
İLCAN: Ülkenin canı,sevdiği.
İLGİ: İki şey arasındaki ilişki; Bir şeye duyulan merak; Eğilim
İLGİN: Yabancı,gurbette yaşayan.
İLGÜN: Ülke güneşi. Başkaları,yabancılar.
İLKAY: Ayın ilk hali.
İLKBAHAR: Yılın ılık mevsimi
İLKCAN: İlk doğan çocuklara verilen ad.
İLKE: Temel alınan düşünce, kural
İLKGÜZ: Eylül ayı
İLKİM: İlk çocuğum anlamında
İLKİN: İlk çocuklar için kullanılan adlardan. Önce,öncelikle.
İLKNUR: İlk ışık
İLKYAZ: İlkbahar
İLTER: Yurdu koruyan, yurtsever.
İMRAN: Evine bağlı, evcimen anlamında
İMREN: İmrenmek fiilinden, görünen şeyi edinme isteği.
İNANÇ: İnanılan şey
İNCİ: Süslemede kullanılan, istiridyede yetişmiş değerli madde
İNCİLAY: Parlama,ışıldama
İNCİNUR: İnci gibi ışıklı,parlak.
İPAR: Yüksek dağların kar tutmayan yerlerinde yetişen çiçek
İPEK: İpekböceği kozasından elde edilen ince, parlak kumaş. Kibar,zarif.
İREM: Bahçeleriyle ünlü masal kenti
İREN: Özgür, serbest
İSMİHAN: Hükümdar ismi
İYEM: Güzellik,iyilik.
İZEL: El izi anlamında
İZEM: Büyüklük, ululuk
İZGİ: Güzel, adaletli, zeki
İZİM: Önceden bulunduğum yerde bıraktığım belirti anlamında
