MAHİRE: Hünerli,becerikli.
MAHPERİ: Güzeller güzeli.
MAİDE: Üzerinde yemekler bulunan sofra; Yemek, ziyafet
MANOLYA: Bir süs bitkisi
MARAL: Dişi geyik
MAVİSU: Deniz
MAYIS: Bir bahar ayı
MEBRUKE: Kutlu kadın ("mübarek kelimesinin dişisi")
MEDİHA: Övülen,beğenilen,sevilen kadın.
MEHİR: Ay parçası
MEHPARE: Ay parçası gibi güzel.
MEHTAP: Ay ışığı,dolunay.
MEHVEŞ: Ay gibi güzel kadın
MELDA: İnce ve taze bedenli
MELEK: Allah katında bulunan ruhani varlıkların her biri; Pek güzel, yumuşak huylu ve masum (mecazi)
MELİHA: Güzel,şirin,sevimli.
MELİKE: Kadın hükümdar,padişah eşi.
MELİS: Bal, bal arısı
MELİSA: Oğul otu
MELTEM: Yazın karadan denize doğru esen yel
MENEKŞE: Mor beyaz renkli, kokulu, yuvarlak yapraklı bir çiçek
MERAL: Dişi geyik,ceylan.
MERCAN: deniz dibine ağaç gibi kök salarak büyüyen, hayvan gibi duyguya sahip, kırmızı renkli, kalker iskeletli bir canlı türü
MERİÇ: Bulgaristan`dan çıkıp Edirne
yakınlarında Arda ve Tunca ile birleştikten sonra Türk-Yunan sınırı boyunca akarak Enez yakınlarında Ege Denizi`ne dökülen ırmak MERİH: Mars gezegeni
MERVE: Mekke`de Safa dağının karşısındaki kırmızı renkli tepenin adı
MERYEM: İsa peygamberin annesinin adı
MERZE: Mercan.
MEYYAL: Meyleden,aşırı istekli. Fazlaca eğilen. Eğik.
MISRA: Manzumenin satırlarından her biri,dizeler.
MİHRİBAN: Dost,sevgili,yarendeş. İyi yürekli,güler yüzlü.
MİHRİCAN: Dost,sevgili. Sonbahar.
MİHRİGÜL: Güler yüzlü,dost,sevecen,güzel.
MİHRİNAZ: Çok nazlı.
MİHRİNUR: Güldüğünde ışıklar saçan.
MİMOZA: Bir süs bitkisi
MİNA: Mine. Liman. Şişe,cam,billur. Şarap şişesi.
MİNE: İnce ve parlak nakış; Madenler üzerine vurulan renkli cam tabakası; Şişe, cam, billur sırça
MİRAY: Yılın ilk aylarında doğan
MİRCAN: Güneş gibi aydınlık.
MÜGE: İnci çiçeği
MÜJDE: Sevindirici haber; İyi haber getirene verilen bağış
MÜJGAN: Kirpikler.
