NADİDE: Az bulunur,görülmemiş. Çok değerli,eşsiz.
NADİRE: Az bulunan.
NAĞME: Güzel uyumlu ses, ezgi; Birinin yalandan ve nazlanarak söylediği söz
NAHİDE: Venüs gezegeni. Ergenlik çağında genç kız.
NARİN: İnce, ince yapılı, kibar
NAŞİDE: Şair,şiir okuyan ve yazan.
NAZ: İsteksiz gibi görünen, çekingen davranış
NAZAN: Cilve yapan,nazlanan,nazenin.
NAZER: Nazar
NAZGÜL: Gül kadar güzel olan,nazlı.
NAZLI(M): Naz yapan; İşveli(m), edalı(m)
NAZLIHAN: Naz yapan han anlamında
NECLA: Evlat,çocuk. Soylu.
NEFİSE: Çok güzel,değerli.
NEHAR: Gündüz anlamındadır
NEHİR: Akarsu, ırmak
NEHİRE: Gereğinden fazla.
NERGİS: Bir süs bitkisi
NERMİN: Yumuşak,narin,ince.
NESLİ: Soylu.
NESLİHAN: Han soyundan. Sevgi ile hükmeden.
NESLİŞAH: Şah soyundan
NESRİN: Yaban gülü
NEŞE: Gönül açıklığı(m), sevinc(im)
NEŞVE: Keyif,neşe.
NEVA: Ses, ahenk; Güç, zenginlik, servet; Nasip; Türk müziğinde bir makam
NEVAL: Talih,kader,kısmet.
NEVADE: Torun anlamında
NEVBAHAR: İlkbahar, ilkyaz
NEVESER: Türk Müziğinde Dede Efendi`nin bulduğu bileşik bir makam
NEVGECE: Yeni yeni oluşan gece
NEVGÜL: Yeni açmış gül
NEVRA: Beyaz çiçek. Işıklı olma,parlaklık.
NEVRES: Yeni yetişen.
NEYİR: Işıklı, aydınlık, parlak
NİGAR: Resim kadar güzel sevgili; Nakış; Resim
NİHAL: İnce ve düzgün vücutlu sevgili. Fidan,taze sürgün.
NİHAN: Saklanmış, gizli olan; Sır
NİL: Çivit. Mısır`da bir nehir
NİLAY: Işıklı mavi,ışıklı lacivert.
NİLGÜN: Lacivert renkli, çivit renginde
NİLÜFER: Durgun sularda yetişen, değişik renkli ve uzun ömürlü su bitkisi
NİRAN: Nurlar,aydınlıklar,ışıklar. Ateşler. Cehennem.
NİSA: Kadın,kadınlar.
NİSAN: Gelin çiçeği; İlkbaharın ilk ayı
NUR: Aydınlık, parıltı, parlaklık
NURAN: Nurlu,ışıklı.
NURAY: Işık saçan.
NURCAN: Aydınlık insan.
NURFER: Işık veren,aydınlatan,ferahlatan.
NURGÜL: Nur+Gül
NURGÜN: Nur+Gün
NURPERİ: Bir peri kadar göz kamaştırıcı güzelliğe sahip olan.
NURSAL: Işıksal ışıkla ilgili
NURSAY: Işık gibi say, ışık gibi bil anlamında
NURSELİ: Işık seli (yağmuru) anlamında
NURSEZA: Nura layık, ışığa, aydınlığa layık anlamında
NURTEN: Işık gibi duru tenli anlamında
NUTİYE:Gökyüzündeki en parlak yıldız
NÜKET: Nükte, zarif, güzel sözler
NÜKHET: Güzel koku
NÜKTE: İnce anlamlı, düşündürücü şaka söz
